#####################################################################  
||.. .....................................................  ......  || 
||.. %%%%%%%%%%%%%%%%        ...     %%%%%%%%%%%%%%  |%|..   %%%%   || 
||..        |%|   |%|     |%|...     |%|        |%|  |%|..    |%|   || 
||..        |%|   |%|     |%|...     |%|        |%|  |%|..    |%|   || 
||..        %%%%%%%%  . . |%|...     %%%%%%%%%%%%%%     ..   %%%%.  || 
||..        |%|       . . |%|...    ............... |%| ..       .  || 
||..        %%%%%%%%%%. . |%|...    %%%%%%%%%%%%    |%| ..   %%%%.  || 
||..               |%|.             |%|......       |%| ..    |%|.  || 
||..     ......... |%|.             |%|......|%|        ..    |%|.  || 
||..|%|  |%|%%%|%|.|%|. |%|            ......|%|        ..|%| |%|.  || 
||..|%|  |%|   |%|..    %%%%%%%%%%%%%  ......|%|         .|%|.      || 
||..|%|  |%|   |%|..           ...|%|     %%%%%%        ..|%|.      || 
||..|%|            .           ...|%|               |%| ..|%|.      || 
||..|%|  %%%%%%%%%%%%%%        ...|%|%%%%%%%%%%     |%| ..|%|%%%%%  || 
||...............................................       ..........  || 
||   ............................................        .........  || 
||..|%|  |%|   |%|..    %%%%%%%%%%%%%  ......|%|    |%| ..|%|.      || 
||..|%|  |%|   |%|..           ...|%|     %%%%%%    |%| ..|%|.      || 
||..|%|            .           ...|%|               |%| ..|%|.      || 
||..|%|  %%%%%%%%%%%%%%        ...|%|%%%%%%%%%%     |%| ..|%|%%%%%  || 
||...............................................   |%| ..........  || 
||  .............................................        .........  || 
#####################################################################  
